7,7
1111111
1033261
1333221
1343421
1733331
1734381
1111111
10,12
111111111111
103743352261
133423312221
133333397321
113373222321
123333333711
125333333331
123234433321
162234333821
111111111111
10,12
111111111111
133143352261
103473312221
133333397321
113343224321
123333333711
125347734331
121134433321
162234333821
111111111111
